....................
....................
....................
....................
....................
....................
....................
....................
....................
....................
....................
.......0............
..................K.
WLWWWWWWWWWWWWWWWWWW
............W.......
............W.......
............L.......
............W......E
............WWWWWWWW
....................
.B....K.............