....................
....................
...0................
..................K.
WLWWWWWWWWWWWWWWWWWW
....................
....................
....................
....................
....................
....................
....................
....................
............WWWWWWWW
............W.......
............W.......
............L.......
............W......E
............WWWWWWWW
....................
.B....K.............