....................
....................
....................
....................
....................
....................
....................
....................
....................
....................
....................
....................
....................
....................
....................
....................
.................E..
...............WWWWW
...............WWWWW
..0............WWWWW
........B......WWWWW