....................
....................
....................
....................
....................
....................
....................
....................
....................
....................
....................
....................
....................
....................
....................
..0.................
.................E..
WWWWW..........WWWWW
...............WWWWW
.....B.........WWWWW
...............WWWWW