....................
....................
....................
....................
....................
....................
....................
....................
....................
....................
....................
....................
....................
....................
....................
...E................
WWWWWWW......WWWWW..
...........W........
.0.B.....W..........
........W...........
WWWWWWWWWWWWWWWWWWWW