....................
....................
....................
....................
....................
....................
....................
....................
....................
....................
.................X..
..............._____
....................
..............._____
....................
........_____.......
...............K....
WWWWWWW......WWWWWWW
...........W........
.0.B.......W........
...........W........