....................
.W...W..WWWW..W..W..
..W.W...W..W..W..W..
...W....W..W..W..W..
...W....W..W..W..W..
...W....WWWW..WWWW..
....................
.W...W..WWW...W..W..
.W...W...W....WW.W..
.W.W.W...W....W.WW..
..W.W...WWW...W..W..
....................
....................
....................
....................
....................
....................
....................
....................
..0.................
....................