....................
..W..W..WWWW..W..W..
..W..W..W..W..W..W..
...WW...W..W..W..W..
...WW...W..W..W..W..
...WW...WWWW..WWWW..
....................
.W.......W.W.W..W...
..W.....W..W.WW.W...
...W.W.W...W.W.WW...
....W.W....W.W..W...
....................
....................
....................
....................
....................
....................
....................
....................
..0.................
....................
