....................
....................
....................
....................
....................
....................
....................
....................
....................
....................
....................
....................
....................
.................E..
____________________
____________________
....................
_____WWWWWWWWWWWWWWW
....................
__________________0_
....................