....................
....................
....................
....................
....................
....................
....................
....................
....................
....................
....................
....................
....................
.................E..
____________________
____________________
.....WWWWWWWWWWWWWWW
___________.........
....................
__________________0_
....................