....................
....................
....................
....................
....................
....................
....................
........B...........
.........WWTTTTTTTTT
.........WW.........
TTTTTWWW.WW.........
.........WW.......E.
_____WWWWWWWWWWWWWWW
....................
WWWWWWWWWWW.........
WWWWWWWWWWW.........
.........WW.......B.
....0....WW.........
.........WWWWWWW____
....................
WWWWWWWWWWWWWWWWWWWW