....................
....................
....................
....................
....................
....................
....................
....................
....................
....................
....................
....................
....................
....................
....................
....................
....................
....................
..0.................
..................E.
WWWWWWWWWWWWWWWWWWWW