..................E.
................____
....................
............____....
....................
........____........
....................
....____............
____................
....................
....____............
....................
........____........
....................
............____....
....................
................____
....................
..0.........____....
....................
WWWWWWWWWWWWWWWWWWWW
