..................E.
................____
....................
............____....
....................
........____........
....................
....____............
....................
____................
....................
....____............
....................
........____........
....................
............____....
....................
................____
....................
.0..........____....
....................