....................
...........K......0.
....................
..WWWWWWWWWWWWWWWWWW
....T.....TTT.TT...W
....SWWWWSWWWWSWW___
.....S.........SW...
.....S...ST..S.SW.._
.....S..WWSWWW_SW..S
.....S..W....W..WW..
.....S..WXW..W__W...
.....S..WW...W..W_W_
.........._TTWS_W...
.............W..WT..
..S.....SST..W__WW._
..W..________W..W..W
..W...B.T.....__WT..
..W.....S...S...W_._
.._________T____T...
...B.......T....T___
......SS.....SS.....