....................
....................
....................
....................
....................
....................
....................
....................
....................
....................
....................
....................
....................
....................
....................
....................
..................E.
.............WWWWWWW
.............WWWWWWW
.0....B......WWWWWWW
.............WWWWWWW