....................
....................
....................
....................
....................
....................
....................
....................
....................
....................
....................
....................
....................
....................
....................
....................
...............WWWWW
...0...........L....
...............W....
........K......W..E.
WWWWWWWWWWWWWWWWWWWW
