....................
....................
....................
....................
....................
....................
....................
....................
....................
....................
....................
....................
....................
....................
....................
....................
....................
.............K......
..0.................
..................X.
WWWWWWWSSSWWSSSWWWWW