....................
....................
....................
...WW..........WW...
..W..W........W..W..
.WWW..W......W..WWW.
..W..............W..
....WWWWW.WWWWW.....
....W...W.W.........
....W...W.WWWW......
....W..WW.W.........
....WWWWW.WWWWW.....
....................
....................
....................
....................
....................
....................
...............L....
.........0.....L....
...K...........L..E.