....................
....................
....................
....................
....................
....................
....................
....................
....................
..................L.
___SSSSS_SSSSSSS_W.W
_................W.W
_.........B......WEW
_...................
_...................
_____SSS__SS___...__
..............K.....
.................___
....................
..0.............____
......S....SS.......