WWWWWWWWWWWWWWWWWWWWWW
W....................W
W....................W
W....................W
W....................W
W....................W
W....................W
W....................W
W....................W
W....................W
W....................W
W....................W
W....................W
W....................W
W....................W
W....................W
W....................W
W....................W
W....................W
W....................W
W.0..................W
W...................EW
WWWWWWWWWWWWWWWWWWWWWW