....................
....................
....................
....................
....................
....................
....................
....................
....................
....................
....................
....................
....................
....................
....................
..0...............E.
.............WWWWWWW
.............WWWWWWW
......B......WWWWWWW
.............WWWWWWW
WWWWWWWWWWWWWWWWWWWW