....................
....................
....................
....................
....................
....................
....................
....................
....................
....................
....................
....................
....................
....................
....................
....................
....................
...............L....
.........0.....L....
...K...........L..E.
WWWWWWWWWWWWWWWWWWWW
