....................
....................
....................
....................
....................
....................
....................
....................
....................
....................
....L...............
....W...............
....W.E.............
____WWWWW.........0.
....................
____..._..._..._____
....................
...____......_______
....................
....____________....
..........K.........