....................
....................
....................
....................
....................
....................
....................
....................
........B...........
WWWWWWWWTWWTTTTTTTTT
TTTTTTTTTWW.........
TTTTTTTT.WW.........
.........WW.......E.
_____WWWWWWWWWWWWWWW
....................
WWWWWWWWWWW.........
WWWWWWWWWWW.........
.........WW.......B.
....0....WW.........
.........WWWWWWW____
....................