....................
....................
....................
....................
....................
....................
................WWWW
................W...
.............0..L.E.
................W...
....____________WWWW
....................
____..___.._____....
....................
..___________.......
....................
____.....___________
....................
...______________...
..........K.........
WWWWWWWWWWWWWWWWWWWW