....................
....................
....................
....................
....................
....................
....................
....................
...........WWWWW....
...........W...W....
...........L...L....
__WWW..___WWTTTWW___
....WK..............
__..WWWWWWWWTTTWWWWW
....................
__..................
.................E..
WWWWWW_W...WWWWWWWWW
.....WBW...WWWWWWWWW
.0...W_W...WWWWWWWWW
...........WWWWWWWWW