....................
....................
....................
....................
....................
....................
....................
....................
....................
....................
....................
....................
K...................
....................
WW..................
.W..................
.WWW.............E..
...W....WWW...WWWWWW
...WWB..WWW...WWWWWW
..0...WWWWW...WWWWWW
..............WWWWWW