....................
....................
....................
....................
....................
....................
....................
....................
....................
..................L.
___SSSSS_SSSSSSS_W.W
_................WEW
_....B..............
_...................
_...................
____SSS___SS___...__
..............K.....
.................___
....................
..0.............____
......S....SS.......